xxxxxxxxxxxxxxxxxx
x----------------x
xxx-----E---xxx--x
x----------------x
x----------------x
x----------------x
x------xxx-------x
x---------xxxxx--x
x---------x------x
xxxxxxxxxxxxxxxxxx